
R 1400 1000

NO ./srcs/capy1.xpm
SO ./srcs/capy3.xpm
WE ./srcs/ccapy.xpm
EA ./srcs/frogo.xpm




F 51,52,99 

C 209,229,253

S ./srcs/barrel.xpm


        1111111111111111111111111    
        1000000000110000000010001
        1011000001110000000000001
        100100000000000E000020021
111111111011000001110000000000001
100000000011000001110111111111111
11110111111111011100000010001
11110111111111011101010012001
11000000110101011100000010001
10000000000000001100002000001
10000000000000001101010010001
1100000111010101111101111000111
11110111 1110101 101111010001
11111111 1111111 111111111111